网站地址：www.baidu.com	搜索引擎
网站地址：www.163.com	IT综合
网站地址：www.taobao.com	网上商城
网站地址：www.tmall.com	网上商城
网站地址：	视频电影
网站地址：csdn.net	IT综合
网站地址：pconline.com.cn	IT综合
网站地址：tech.sina.com.cn	IT综合
网站地址：wap.yesky.com	IT综合
网站地址：www.weibo.com	IT综合
网站地址：techweb.com.cn	IT综合
网站地址：news.duote.com	IT综合
网站地址：www.zhuangjiba.com	IT综合
网站地址：www.downyi.com	IT综合
网站地址：ithome.com	IT综合
网站地址：www.pconline.com.cn	IT综合
网站地址：www.gzfc.net	IT综合
网站地址：wang1314.com	IT综合
网站地址：blog.51cto.com	IT综合
网站地址：pchome.net	IT综合
网站地址：www.300.cn	IT综合
网站地址：www.shuotui.com	IT综合
网站地址：yuzhua.com	IT综合
网站地址：fayagu.com	IT综合
网站地址：uc.cn	IT综合
网站地址：driver.zol.com.cn	IT综合
网站地址：diandian.com	IT综合
网站地址：thethirdmedia.com	IT综合
网站地址：rz520.com	IT综合
网站地址：top.zol.com.cn	IT综合
网站地址：email.163.com	IT综合
网站地址：www.wenkub.com	IT综合
网站地址：www.laomaozy.com	IT综合
网站地址：niaogebiji.com	IT综合
网站地址：lusongsong.com	IT综合
网站地址：itpub.net	IT综合
网站地址：mydigit.cn	IT综合
网站地址：www.iplaysoft.com	IT综合
网站地址：liebao.cn	IT综合
网站地址：baiduseoguide.com	IT综合
网站地址：xianshuabao.com	IT综合
网站地址：www.amd.com	IT综合
网站地址：www.b2360.com	IT综合
网站地址：hasee.com	IT综合
网站地址：www.tuijiong.com	IT综合
网站地址：chinafix.com	IT综合
网站地址：pcbeta.com	IT综合
网站地址：hy755.cn	IT综合
网站地址：www.coder100.com	IT综合
网站地址：razerzone.com	IT综合
网站地址：www.shangyouw.cn	IT综合
网站地址：yinxiang.com	IT综合
网站地址：www.iconfont.cn	IT综合
网站地址：ai.baidu.com	IT综合
网站地址：epwk.com	IT综合
网站地址：www.hy755.cn	IT综合
网站地址：www.php.cn	IT综合
网站地址：ipcfun.com	IT综合
网站地址：www.ctocio.com.cn	IT综合
网站地址：96weixin.com	IT综合
网站地址：nsw88.com	IT综合
网站地址：www.longdouseo.com	IT综合
网站地址：www.qinzhiqiang.com	IT综合
网站地址：benq.com.cn	IT综合
网站地址：weste.net	IT综合
网站地址：www.wui5.com	IT综合
网站地址：www.zmki.cn	IT综合
网站地址：linkshop.com.cn	IT综合
网站地址：www.tqyb.com.cn	天气预报
网站地址：www.ceic.ac.cn	天气预报
网站地址：nmc.cn	天气预报
网站地址：www.weather.com.cn	天气预报
网站地址：waptianqi.2345.com	天气预报
网站地址：baidu.weather.com.cn	天气预报
网站地址：weather.zuzuche.com	天气预报
网站地址：www.30ttq.com	天气预报
网站地址：www.hzqx.com	天气预报
网站地址：typhoon.weather.com.cn	天气预报
网站地址：www.cma.gov.cn	天气预报
网站地址：tianqi.exinshi.com	天气预报
网站地址：www.hnqxw.com	天气预报
网站地址：tianqishi.com	天气预报
网站地址：www.tianqi5.cn	天气预报
网站地址：15tianqi.cn	天气预报
网站地址：www.hfqx.com.cn	天气预报
网站地址：www.wz121.com	天气预报
网站地址：xaoyo.com	天气预报
网站地址：www.saturdaysoft.com	天气预报
网站地址：jieqi.911cha.com	天气预报
网站地址：tianqiwang.org	天气预报
网站地址：jsjxkj.com	天气预报
网站地址：sh.weather.com.cn	天气预报
网站地址：www.qx121.com	天气预报
网站地址：www.jxqx.net	天气预报
网站地址：tq321.com	天气预报
网站地址：tz121.com	天气预报
网站地址：www.soweather.com	天气预报
网站地址：www.15tqw.com	天气预报
网站地址：zj.weather.com.cn	天气预报
网站地址：www.tianqishi.com	天气预报
网站地址：gd121.cn	天气预报
网站地址：qzqxw.com	天气预报
网站地址：gx.weather.com.cn	天气预报
网站地址：weather.webmasterhome.cn	天气预报
网站地址：hebei.weather.com.cn	天气预报
网站地址：www.tianqiyubao2.com	天气预报
网站地址：www.hebqx.com	天气预报
网站地址：www.wztf121.com	天气预报
网站地址：bj.weather.com.cn	天气预报
网站地址：st12121.net	天气预报
网站地址：weather.sina.com.cn	天气预报
网站地址：www.hko.gov.hk	天气预报
网站地址：js.weather.com.cn	天气预报
网站地址：zx.bjmemc.com.cn	天气预报
网站地址：www.xaoyo.com	天气预报
网站地址：xian.tianqi.com	天气预报
网站地址：www.19line.cn	天气预报
网站地址：henan.weather.com.cn	天气预报
网站地址：sd.weather.com.cn	天气预报
网站地址：hubei.weather.com.cn	天气预报
网站地址：qixiangwang.cn	天气预报
网站地址：qingdao.tianqi.com	天气预报
网站地址：news.weather.com.cn	天气预报
网站地址：cq.weather.com.cn	天气预报
网站地址：hengdiantour.com	天气预报
网站地址：shanghaitianqi114.com	天气预报
网站地址：shanxi.weather.com.cn	天气预报
网站地址：jinan.tianqi.com	天气预报
网站地址：dongguan.tianqi.com	天气预报
网站地址：cwb.gov.tw	天气预报
网站地址：jiaxing.tianqi.com	天气预报
网站地址：t7online.com	天气预报
网站地址：shaoxing.tianqi.com	天气预报
网站地址：hunan.weather.com.cn	天气预报
网站地址：ah.weather.com.cn	天气预报
网站地址：tianqitong.sina.cn	天气预报
网站地址：handan.tianqi.com	天气预报
网站地址：cz121.com	天气预报
网站地址：chengdu.tianqi.com	天气预报
网站地址：shangqiu.tianqi.com	天气预报
网站地址：baoji.tianqi.com	天气预报
网站地址：suqian.tianqi.com	天气预报
网站地址：zaozhuang.tianqi.com	天气预报
网站地址：hefei.tianqi.com	天气预报
网站地址：dzqxj.com	天气预报
网站地址：wuxi1.tianqi.com	天气预报
网站地址：tianqizhubo.com	天气预报
网站地址：fjzzy.org	天气预报
网站地址：yanyue.cn	餐饮美食
网站地址：xiachufang.com	餐饮美食
网站地址：www.zhms.cn	餐饮美食
网站地址：douguo.com	餐饮美食
网站地址：www.xinshipu.com	餐饮美食
网站地址：meishichina.com	餐饮美食
网站地址：guba.eastmoney.com	餐饮美食
网站地址：meishij.net	餐饮美食
网站地址：www.meishichina.com	餐饮美食
网站地址：foodmate.net	餐饮美食
网站地址：www.meishij.net	餐饮美食
网站地址：js118.com.cn	餐饮美食
网站地址：shipuxiu.com	餐饮美食
网站地址：home.meishichina.com	餐饮美食
网站地址：health.people.com.cn	餐饮美食
网站地址：www.yanpk.com	餐饮美食
网站地址：m.yanyue.cn	餐饮美食
网站地址：www.yili.com	餐饮美食
网站地址：tobacco.gov.cn	餐饮美食
网站地址：canyin.com	餐饮美食
网站地址：wine-world.com	餐饮美食
网站地址：ele.me	餐饮美食
网站地址：www.starbucks.com.cn	餐饮美食
网站地址：cy8.com.cn	餐饮美食
网站地址：lzlj.com	餐饮美食
网站地址：xiaomishu.com	餐饮美食
网站地址：mcdonalds.com.cn	餐饮美食
网站地址：holiland.com	餐饮美食
网站地址：pepsico.com.cn	餐饮美食
网站地址：www.shuanghui.net	餐饮美食
网站地址：shiwuxiangke.com	餐饮美食
网站地址：mytgb.com	餐饮美食
网站地址：moutaichina.com	餐饮美食
网站地址：spdl.com	餐饮美食
网站地址：www.spzs.com	餐饮美食
网站地址：www.lhecha.com	餐饮美食
网站地址：haagendazs.com.cn	餐饮美食
网站地址：www.douguo.com	餐饮美食
网站地址：www.haidilao.com	餐饮美食
网站地址：maky.com.cn	餐饮美食
网站地址：4008823823.com.cn	餐饮美食
网站地址：www.simcf.com	餐饮美食
网站地址：www.xiantao.com	餐饮美食
网站地址：haocai777.com	餐饮美食
